-2 -2 -2 -2 -2 -2 -2 -2 -2 -2
door2 start -1 01 02 03 04 05 06 -2
-2 07 -1 -1 -1 -1 09 10 11 -2
-2 12 13 14 enemy2 -1 08 16 enemy1 -2
-2 18 19 -1 -1 -1 -1 20 21 -2
-2 22 -1 -1 23 24 25 26 27 -2
-2 28 29 -1 enemy2 -1 -1 -1 enemy1 -2
-2 32 33 -1 -1 -1 34 -1 35 -2
-2 36 37 38 39 40 41 42 end door4
-2 -2 -2 -2 -2 -2 -2 -2 -2 -2